00,00,00,00,00,02,00,00,00,00,00,00,00,00,00,01
00,00,00,00,00,02,00,00,00,00,12,21,01,01,01,01
00,00,00,00,00,02,00,00,00,12,21,01,01,01,01,01
00,00,00,00,12,02,02,00,12,21,01,01,01,01,01,01
00,00,00,12,21,01,02,02,21,01,01,01,01,01,01,01
00,00,12,21,01,01,01,02,01,01,01,01,01,01,01,01
00,12,21,01,01,01,01,02,02,01,01,01,01,01,01,01
12,21,01,01,01,01,01,01,02,02,01,01,01,01,01,02
21,01,01,01,01,01,01,01,01,02,01,01,01,01,01,02
01,01,01,01,01,01,01,01,01,02,02,02,01,01,02,02
01,01,01,01,01,01,01,01,01,10,11,02,02,01,02,02
01,01,01,01,01,01,01,01,10,23,22,11,02,02,02,02
01,01,01,01,01,01,01,01,20,13,12,21,02,02,02,02
11,01,01,01,01,01,01,01,01,20,21,02,02,02,02,02
22,11,01,01,01,01,01,01,01,02,02,02,02,02,02,02
00,22,11,01,01,01,01,02,02,02,02,02,02,02,02,02
